################################
#            X X               #
#  X    XXXX      XXXX         #
#  X    X  X  X   X            #
#  X    X  X  X   X            #
#  XXX  XXXX  X   XXXX         #
#                              #
################################